111111111
1000C0001
100000101
100101E01
100000001
101001001
101010011
1P10C10C1
111111111
