111111111111
100P0C000H01
101110111111
101C101000C1
101010001111
101011000001
10100001V101
1C1C11V001E1
111111111111
