111111111111111111111111111111111111111
1P00000000111C0000000011000000000000001
11111111001011100000011C100C0000V000011
111C00101000001000000100110100011000111
11111000001001110000110110000011110C111
11C1110000000C0001000000100110000V11001
100100011000000000V00110000000000000001
1011000100V0010000000000000000110000001
1000000100001110000010000000011000001E1
111111111111111111111111111111111111111
